000000000111110000000000000000
000000001111111100000000000000
000000011111111110100000000000
000000111111111111110000000000
000000111111111111111100000000
000000111111111111111110000000
000001111111111111111110000000
000001111111111111111100000000
000001111111111111111000000000
000000111111111111111000000000
000000111111111111110000000000
000000011110111111110000000000
000000001100011111000000000000
000000000000001110000000000000
000000000000000000000000000000
000000000000000000000000000000
000000000000000000000000000000
000000000000000000222222222200
000000000000000002222222222200
000000000000000002222222222220
000000000000000002222222222220
000000000000000002222222222220
000000000000000002222222222220
000000000000000002222222222200
000000000000000000222222222000
000000000000000000000000000000
000000000000000000000000000000
000000000000000000000000000000

